B11111111111111
w00111111111111
000000100000111
b10000100000110
111100100000100
111100000000100
110000100100110
000011111100110
010011111100110
011111101100110
011100100111110
011110001111110
111111001101010
111111001011110
W00000001111100
