b11111111111111
111111111111111
111111111111111
111111111111111
111111111111111
111111111111111
111111111111111
111111111111111
111111111111111
111111111111111
111111w11111111
000000000000000
000000000000000
000000000000000
000000000000000