11111111111111B
111111111111111
000100001000000
0W0100001000000
000100001000000
111100001000000
000000001000000
000000101000000
000000100000000
000000100000000
000000100000000
000000100000000
00000010000000w
111111111111111
b11111111111111