111111111111111
100000000000001
100000000000001
100111111111001
100111111111001
100110000011001
100110000011001
1001100B0011001
100110010011001
100110010011001
100110010011001
100110010011001
100110010011001
100110010011001
b00w10011W11101
