b11111110011111
111111110011111
111000100000011
w00000100110011
000000100110011
111110001100011
W00100110000111
110100000000111
110B00001111111
110001110000000
110011000000000
110011111111100
110000000000011
000000000000011
011111111111111
